NO ./textures/north.xpm
SO ./textures/south.xpm
WE ./textures/west.xpm
EA ./textures/east.xpm
F 120,80,60
C 180,210,240

1111111111
1W00000001
1011111101
1010000101
1010110101
1010000001
1111111111
