F 0,   160,240

		NO ./north.xpm
SO ./south.xpm
C 100,200, 50
WE ./west.xpm
EA ./east.xpm




111111111111
1000000000011111111
1N00000000000000001
1000000000000000001
1111111100000000001
1000000000000011111
100000000000001
100000000000001
111111111111111
