NO ./assets/north.xpm
SO ./assets/south.xpm
WE ./assets/west.xpm
EA ./assets/east.xpm
F 220,100,0
C 225,30,0

111111111111
100000000001
101111111101
1000000000E1
111011111101
100000000001
111111111111
