NO ./assets/north.xpm
SO ./assets/south.xpm
WE ./assets/west.xpm
EA ./assets/east.xpm
F 0, 128 , 255
C 255 , 255, 255

1111111111
1000000001111
1000111111001
10W01    1001
1000111110001
100000000111
1000111101
10001  101
1001   101
1001   101
1000111101
1000000001
1000000001
 10000011
 11000111
  11111
