NO ./assets/north.xpm
SO ./assets/south.xpm
WE ./assets/west.xpm
EA ./assets/east.xpm
F 40,40,40
C 200,240,255

111111111111111111111
1W00000000000000000001
111111111111111111101
100000000000000000101
101111111111111110101
101000000000000010101
101011111111111010101
101010000000001010101
101010111111101010101
101010100000101010101
101010101110101010101
101010100010101010101
101010111010101010101
101010000010101010101
101011111110101010101
101000000000001010101
101111111111111110101
100000000000000000001
111111111111111111111
