F 0,255,0
C 225,0,0

NO ./north.xpm
SO ./south.xpm
WE ./west.xpm
banan

11111111111
10000000001
10000100001
10001 10001
100001000E1
10000000001
11111111111
