F 0,255,0
NO ./north.xpm
SO ./south.xpm
C 225,0,0
WE ./west.xpm
EA ./east.xpm

111111
1000011111
1001N000011
10000000111
111111111
