NO ./assets/north.xpm
SO ./assets/south.xpm
WE ./assets/west.xpm
EA ./assets/east.xpm
F 100,100,100
C 200,200,200

1111111
1000001
100N001
1000001
1111111
