NO ./assets/north.xpm
SO ./assets/south.xpm
WE ./assets/west.xpm
EA ./assets/east.xpm
F 139,69,19
C 135,206,235

111111
100001
101001
100N01
111111
