F 0,255,0
C 225,0,0

NO ./north.xpm
SO ./south.xpm
WE ./west.xpm
EA ./east.xpm

11111111111
10000000001
1000010N001
10001 10001
100001000E1
10000000001
