F 0,160,240
NO ./north.xpm
SO ./south.xpm
C 100,200, 50
WE ./west.xpm
EA ./east.xpm



11111
10001
1N001
100Y1
11111
