F 0,255,0
C 225,0,0

NO ./north.xpm
SO ./south.xpm
WE ./west.xpm
EA ./east.xpm

11111111111
10000000001
10000100001
10001 10001
10000100001
10000000001
11111111111
