NO ./textures/north.xpm
SO ./textures/south.xpm
WE ./textures/west.xpm
EA ./textures/east.xpm
F 0, 128 , 255
C 255 , 255, 255

1111111111
1000000001
1000  0001
10W0    01
1000000001
1111111111
